XXXXXXX2222XXXXXXX
X              H0X
X                X
X                X
X                X
X                X
X    XX   5H1    X
X     X 55       X
X    SX5         X
X     X655 H2    X
X    86   7      X
X                X
X                X
X     B2         X
X                X
X              H0X
X                X
XXXXXXX1111XXXXXXX
